Humans: 0
RRRRRRRRRRRRRRRRRRRRRRRRRRRRR
R...........................R
R...........................R
R...........................R
R...........................R
R...........RRRGRGRRR.......R
R...........R.......R.......R
R...........R...@...L.......R
R...........R...............R
R...........R.......L.......R
R...........RRRGRGRRR.......R
R...........................R
R...........................R
R...........................R
R...........................R
RRRRRRRRRRRRRRRRRRRRRRRRRRRRR